1111111111
1111111111
1112222111
1112112111
1112112111
1112112111
1112112111
1112222111
1111111111
1111111111
---
[
	{
		"type": "Chest",
		"x": 5,
		"y": 5,
		"level": 0,
		"opened": "False"
	}
]
