1111111111
1111111111
1112222111
1112112111
1112112111
1112112111
1112112111
1112222111
1111111111
1111111111